0000000000000000000000000000000000000000000
0000000000000000011000000000000000000001100
0000000000000000011000000000000000000001100
0000000000000000000000000000000000000000000
0011000000000000011000001100000000000001100
0011011111111111011000001101111111111101100
0000000000000000000000000000000000000000000
0000000000000000000000000000000000000000000
0000000000000000000000000000000000000000000
0011011111111111011000001101111111111101100
0011000000000000011000001100000000000001100
0000000000000000000000000000000000000000000
0011000000000000000000001100000000000000000
0011000000000000000000001100000000000000000
0000000000000000000000000000000000000000000